2.6
29
24
00 00 00 00 00 00 00 00 00 00 00 00 00 00 00 00 00 00 00 00 00 00 00 00 00 00 00 00 00 
00 00 01 00 00 00 00 00 00 00 00 00 00 00 00 00 00 00 00 00 00 00 00 00 00 00 00 00 00 
00 00 01 00 00 00 00 00 00 00 00 00 00 00 00 00 00 00 00 00 00 00 00 00 00 00 00 00 00 
00 01 01 01 01 01 01 01 00 01 01 01 01 01 01 01 01 01 01 01 00 01 01 01 01 01 01 01 00 
00 01 01 01 01 01 01 01 00 01 01 01 01 01 01 01 01 01 01 01 01 01 01 01 01 01 01 01 00 
00 01 01 01 01 01 01 01 01 01 01 01 01 01 01 01 01 01 01 01 00 01 01 01 00 01 01 01 00 
00 01 01 01 01 01 01 01 00 01 01 01 00 00 00 00 00 00 00 00 00 01 01 01 00 01 01 01 00 
00 00 00 00 00 00 00 00 00 01 01 01 00 00 00 00 00 00 00 00 00 01 01 01 00 01 01 01 00 
00 00 00 00 00 00 00 00 00 01 01 01 00 01 01 01 01 01 01 01 00 01 01 01 00 01 01 01 00 
00 01 01 01 01 01 01 01 00 01 01 01 00 01 01 01 01 01 01 01 01 01 01 01 00 01 01 01 00 
00 01 01 01 01 01 01 01 01 01 01 01 00 01 01 01 01 01 01 01 00 01 01 01 00 01 01 01 00 
00 01 01 01 01 01 01 01 00 01 01 01 00 01 00 00 00 00 00 00 00 01 01 01 00 01 01 01 00 
00 00 00 00 00 00 00 00 00 01 01 01 00 01 00 00 00 00 00 00 00 01 01 01 00 01 01 01 00 
00 00 00 00 00 00 00 00 00 01 01 01 00 01 01 01 01 01 01 01 00 01 01 01 00 01 01 01 00 
00 01 01 01 01 01 01 01 00 01 01 01 00 01 01 01 01 01 01 01 01 01 01 01 00 01 01 01 00 
00 01 01 01 01 01 01 01 01 01 01 01 00 01 01 01 01 01 01 01 00 01 01 01 00 01 01 01 00 
00 01 01 01 01 01 01 01 00 01 01 01 00 01 01 01 01 01 01 01 00 01 01 01 00 01 01 01 00 
00 01 01 01 01 01 01 01 00 01 01 01 00 00 00 00 00 00 00 00 00 01 01 01 00 00 01 00 00 
00 01 01 01 01 01 01 01 00 00 01 00 00 00 00 00 00 00 00 00 00 01 01 01 00 00 01 00 00 
00 01 01 01 01 01 01 01 00 01 01 01 01 01 01 01 01 01 01 01 01 01 01 01 00 01 01 01 00 
00 01 01 01 01 01 01 01 01 01 01 01 01 01 01 01 01 01 01 01 01 01 01 01 00 01 01 01 00 
00 01 01 01 01 01 01 01 00 01 01 01 01 01 01 01 01 01 01 01 01 01 01 01 00 01 01 01 00 
00 00 00 00 00 00 00 00 00 00 00 00 00 00 00 00 00 00 00 00 00 00 00 00 00 00 00 00 00 
00 00 00 00 00 00 00 00 00 00 00 00 00 00 00 00 00 00 00 00 00 00 00 00 00 00 00 00 00 
46 52 52 52 52 52 52 52 52 52 52 52 52 52 52 52 52 52 52 52 52 52 52 52 52 52 52 52 47 
35 26 00 26 26 26 26 26 35 26 26 26 26 26 26 26 26 26 26 26 35 26 26 26 26 26 26 26 35 
35 25 00 25 25 25 25 25 35 25 25 25 25 25 25 25 25 25 25 25 26 25 25 25 25 25 25 25 35 
35 1022 00 1022 00 00 00 00 26 00 00 00 00 00 00 00 00 00 00 1021 25 00 00 00 00 00 00 00 35 
35 00 00 00 00 00 00 00 25 00 00 00 00 00 00 00 00 00 00 00 00 00 00 00 00 00 00 00 35 
35 00 00 00 00 00 00 00 00 00 00 00 00 00 00 00 00 00 00 00 35 00 00 00 35 00 00 00 35 
35 00 00 00 00 00 00 00 35 00 00 00 35 26 26 26 26 26 26 26 35 00 00 00 35 00 00 00 35 
35 26 26 26 26 26 26 26 35 00 00 00 35 25 25 25 25 25 25 25 26 00 00 00 35 00 00 00 35 
35 25 25 25 25 25 25 25 26 00 00 00 35 1017 00 00 1009 1010 00 00 25 00 00 00 35 00 00 00 35 
35 00 00 1009 1010 00 00 1017 25 00 00 00 35 00 00 00 00 00 00 00 00 00 00 00 35 00 00 00 35 
35 00 00 00 00 00 00 00 00 00 00 00 35 00 00 00 00 00 00 00 35 00 00 00 35 00 00 00 35 
35 00 00 00 00 00 00 00 35 00 00 00 35 00 26 26 26 26 26 26 35 00 00 00 35 00 00 00 35 
35 26 26 26 26 26 26 26 35 00 00 00 35 00 25 25 25 25 25 25 26 00 00 00 35 00 00 00 35 
35 25 25 25 25 25 25 25 26 00 00 00 35 00 00 00 00 1015 1016 1017 25 00 00 00 35 00 00 00 35 
35 1021 00 00 1002 00 00 1021 25 00 00 00 35 00 00 00 00 00 00 00 00 00 00 00 35 00 00 00 35 
35 00 00 00 00 00 00 00 00 00 00 00 35 00 00 00 00 00 00 00 35 00 00 00 35 00 00 00 35 
35 00 00 00 00 00 00 00 35 00 00 00 35 00 00 00 00 00 00 00 35 00 00 00 35 00 00 00 35 
35 00 00 00 00 00 00 00 35 26 00 26 26 26 26 26 26 26 26 26 26 00 00 00 35 26 00 26 35 
35 00 00 00 00 00 00 00 35 25 00 25 25 25 25 25 25 25 25 25 25 00 00 00 35 25 00 25 35 
35 00 1000 1001 00 00 00 00 35 00 00 00 00 00 00 00 00 00 00 00 00 00 00 00 35 00 00 00 35 
35 00 1003 1004 00 00 00 00 00 00 00 00 00 00 00 00 00 00 00 00 00 00 00 00 35 00 00 00 35 
35 00 00 00 00 00 00 00 35 00 00 00 00 00 00 00 00 00 00 00 00 00 00 00 35 00 00 00 54 
26 26 26 26 26 26 26 26 26 26 26 26 26 26 26 26 26 26 26 26 26 26 26 26 26 26 26 26 26 
25 25 25 25 25 25 25 25 25 25 25 25 25 25 25 25 25 25 25 25 25 25 25 25 25 25 25 25 25 
00 00 00 00 00 00 00 00 00 00 00 00 00 00 00 00 00 00 00 00 00 00 00 00 00 00 00 00 00 
00 00 00 00 00 1020 00 00 00 00 00 00 00 1008 00 1008 00 1008 00 00 00 00 00 00 00 00 00 00 00 
00 1019 00 1019 00 1023 00 00 00 00 1005 00 00 1011 00 1011 00 1011 00 1018 37 00 1005 00 00 00 1005 00 00 
00 00 00 00 00 00 00 00 37 00 00 00 00 00 00 00 00 00 00 00 00 00 00 00 00 00 00 00 00 
00 00 00 00 00 00 00 00 00 00 00 00 00 00 00 00 00 00 00 00 00 00 00 00 36 00 00 00 00 
00 00 00 00 00 00 00 00 36 00 00 00 28 29 29 29 29 29 29 29 00 00 00 00 00 00 00 00 00 
00 29 29 29 29 29 29 29 00 00 00 00 00 32 32 32 32 32 32 32 00 00 00 00 00 00 00 00 00 
00 32 32 32 32 32 32 32 00 00 00 00 00 1014 00 00 1006 1007 00 00 37 00 00 00 00 00 00 00 00 
00 00 00 1006 1007 00 00 1014 37 00 00 00 00 00 00 00 00 00 00 00 00 00 00 00 00 00 00 00 00 
00 00 00 00 00 00 00 00 00 00 00 00 00 00 00 00 00 00 00 00 36 00 00 00 00 00 00 00 00 
00 00 00 00 00 00 00 00 36 00 00 00 00 29 29 29 29 29 29 29 00 00 00 00 00 00 00 00 00 
00 29 29 29 29 29 29 29 00 00 00 00 00 32 32 32 32 32 32 32 00 00 00 00 00 00 00 00 00 
00 32 32 32 32 32 32 32 00 00 00 00 00 00 00 00 00 1012 1013 1014 37 00 00 00 00 00 00 00 00 
00 1018 00 00 00 00 00 1018 37 00 00 00 00 00 00 00 00 00 00 00 00 00 00 00 00 00 00 00 00 
00 00 00 00 00 00 00 00 00 00 00 00 00 00 00 00 00 00 00 00 36 00 00 00 00 00 00 00 00 
00 00 00 00 00 00 00 00 36 00 00 00 00 00 00 00 00 00 00 00 00 00 00 00 00 00 00 00 00 
00 00 00 00 00 00 00 00 00 27 00 28 00 29 29 29 29 29 29 29 00 00 00 00 00 27 00 28 00 
00 00 00 00 00 00 00 00 00 30 00 31 32 32 32 32 32 32 32 32 30 00 00 00 00 30 00 31 00 
00 00 00 00 00 00 00 00 00 00 00 00 00 00 00 00 00 00 00 00 00 00 00 00 00 00 00 00 00 
00 00 00 00 00 00 00 00 00 00 00 00 00 00 00 00 00 00 00 00 00 00 00 00 00 00 00 00 00 
00 00 00 00 00 00 00 00 53 00 00 00 00 00 00 00 00 00 00 00 00 00 00 00 00 00 1024 00 00 
00 29 29 29 29 29 29 29 00 29 29 29 29 29 29 29 29 29 29 29 29 29 29 29 00 61 61 61 00 
31 32 32 32 32 32 32 32 32 32 32 32 32 32 32 32 32 32 32 32 32 32 32 32 32 32 32 32 30 
00 00 00 00 00 00 00 00 00 00 00 00 00 00 00 00 00 00 00 00 00 00 00 00 00 00 00 00 00 
0
29
2
7
20
-1
3
null
null
-1
-1
4
2
11
-1
3
11vakt1
null
-1
-1
4
10
12
-1
3
11vakt2
null
-1
-1
4
16
15
-1
3
11vakt3
null
-1
-1
2
13
12
-1
3
null
null
-1
-1
2
14
19
-1
3
null
null
-1
-1
2
15
20
-1
3
null
null
-1
-1
2
14
21
-1
3
null
null
-1
-1
2
16
19
-1
3
null
null
-1
-1
2
16
21
-1
3
null
null
-1
-1
4
2
17
-1
3
11vakt4
null
-1
-1
2
17
20
-1
3
null
null
-1
-1
9
19
19
-1
3
null
null
-1
-1
2
18
20
-1
3
null
null
-1
-1
9
20
20
-1
3
null
null
-1
-1
2
4
3
-1
3
null
null
-1
-1
2
6
3
-1
3
null
null
-1
-1
2
5
4
-1
3
null
null
-1
-1
0
5
3
1
3
null
null
-1
-1
8
2
2
1
3
null
S
0
-1
8
10
18
2
3
null
S
0
-1
8
20
14
4
3
null
E
0
-1
8
20
4
5
3
null
E
0
-1
6
11
21
3
3
null
N
2
0
6
24
4
3
3
null
N
2
0
7
2
9
1
3
null
S
1
-1
7
15
8
6
3
null
S
1
-1
7
16
13
7
3
null
S
1
-1
7
25
7
3
3
null
E
1
-1
3
10
17
2
-1
-1
8
20
2
-1
-1
26
17
0
1
10
