20
20
00 00 00 00 00 00 00 00 00 00 00 00 00 00 00 00 00 00 00 00 
00 00 00 00 00 00 00 00 00 00 00 00 00 00 00 00 00 00 00 00 
00 00 00 00 00 00 00 00 00 00 00 00 00 00 00 00 00 00 00 00 
00 01 01 01 01 01 01 01 01 01 01 01 00 00 00 00 00 00 00 00 
00 01 01 01 01 01 01 01 01 01 01 01 00 00 00 00 00 00 00 00 
00 01 01 01 01 01 01 01 01 01 01 01 00 00 00 00 00 00 00 00 
00 01 01 01 01 01 01 01 01 01 01 01 00 00 00 00 00 00 00 00 
00 01 01 01 01 01 01 01 01 01 01 01 01 01 01 01 01 00 00 00 
00 01 01 01 01 01 01 01 01 01 01 01 01 01 01 01 01 00 00 00 
00 01 01 01 01 01 01 01 01 01 01 01 01 01 01 01 01 00 00 00 
00 01 01 01 01 01 01 01 01 01 01 01 01 01 01 01 01 00 00 00 
00 00 00 00 00 00 00 00 00 00 00 00 00 00 00 00 00 00 00 00 
00 00 00 00 00 00 00 00 00 00 00 00 00 00 00 00 00 00 00 00 
00 00 00 00 00 00 00 00 00 00 00 00 00 00 00 00 00 00 00 00 
00 00 00 00 00 00 00 00 00 00 00 00 00 00 00 00 00 00 00 00 
00 00 00 00 00 00 00 00 00 00 00 00 00 00 00 00 00 00 00 00 
00 00 00 00 00 00 00 00 00 00 00 00 00 00 00 00 00 00 00 00 
00 00 00 00 00 00 00 00 00 00 00 00 00 00 00 00 00 00 00 00 
00 00 00 00 00 00 00 00 00 00 00 00 00 00 00 00 00 00 00 00 
00 00 00 00 00 00 00 00 00 00 00 00 00 00 00 00 00 00 00 00 
34 40 40 40 40 40 40 40 40 40 40 40 35 00 00 00 00 00 00 00 
39 26 26 26 26 26 26 26 26 26 26 26 39 00 00 00 00 00 00 00 
39 25 25 25 25 25 25 25 25 25 25 25 39 00 00 00 00 00 00 00 
39 00 00 00 00 00 00 00 00 00 00 00 39 00 00 00 00 00 00 00 
39 00 00 00 00 00 00 00 00 00 00 00 37 40 40 40 40 35 00 00 
39 00 00 00 00 00 00 00 00 00 00 00 26 26 26 26 26 39 00 00 
39 00 00 00 00 00 00 00 00 00 00 00 25 25 25 25 25 39 00 00 
39 00 00 00 00 00 00 00 00 00 00 00 00 00 00 00 00 39 00 00 
39 00 00 00 00 00 00 00 00 00 00 00 00 00 00 00 00 39 00 00 
37 40 40 40 40 40 40 40 40 40 40 40 40 40 40 40 40 36 00 00 
26 26 26 26 26 26 26 26 26 26 26 26 26 26 26 26 26 26 00 00 
25 25 25 25 25 25 25 25 25 25 25 25 25 25 25 25 25 25 00 00 
00 00 00 00 00 00 00 00 00 00 00 00 00 00 00 00 00 00 00 00 
00 00 00 00 00 00 00 00 00 00 00 00 00 00 00 00 00 00 00 00 
00 00 00 00 00 00 00 00 00 00 00 00 00 00 00 00 00 00 00 00 
00 00 00 00 00 00 00 00 00 00 00 00 00 00 00 00 00 00 00 00 
00 00 00 00 00 00 00 00 00 00 00 00 00 00 00 00 00 00 00 00 
00 00 00 00 00 00 00 00 00 00 00 00 00 00 00 00 00 00 00 00 
00 00 00 00 00 00 00 00 00 00 00 00 00 00 00 00 00 00 00 00 
00 00 00 00 00 00 00 00 00 00 00 00 00 00 00 00 00 00 00 00 
2
5
5
5
1
2
20
1
4
5
1
2
20
2
9
3
4
-1
3
null
null
-1
9
2
5
-1
3
null
null
-1
