3.3
Museum
15
15
49 49 49 49 49 49 49 49 49 49 49 49 48 48 48 
49 49 49 49 49 49 49 49 49 49 49 49 48 48 48 
49 49 49 49 49 49 49 49 49 49 49 49 48 48 48 
49 49 49 49 49 49 49 49 49 49 49 49 48 48 48 
49 49 49 49 49 49 49 49 49 49 49 49 48 48 48 
49 49 49 49 49 49 49 49 49 49 49 49 48 48 48 
49 49 49 49 49 49 49 49 49 49 49 49 48 48 48 
49 49 49 49 49 49 49 49 49 49 49 49 48 48 48 
49 49 49 49 49 49 49 49 49 49 49 49 48 48 48 
49 49 49 49 49 49 49 49 49 49 49 49 48 48 48 
49 49 49 49 49 49 49 49 49 49 49 49 48 48 48 
48 48 48 48 48 48 48 48 48 48 48 48 48 48 48 
48 48 48 48 48 48 48 48 48 48 48 48 48 48 48 
48 48 48 48 48 48 48 48 48 48 48 48 48 48 48 
48 48 48 48 48 48 48 48 48 48 48 48 48 48 48 
48 48 48 48 48 48 48 48 48 48 48 48 48 48 48 
48 48 48 48 1028 1029 1015 1015 1015 48 48 48 48 48 48 
48 48 48 48 48 48 48 48 48 48 48 48 48 48 48 
48 48 48 1033 1048 1049 1050 1035 48 48 48 48 48 48 48 
48 48 48 1033 1049 1050 1035 48 48 48 48 48 48 48 48 
48 48 48 48 48 48 48 48 48 48 48 48 48 48 48 
48 48 48 48 48 48 48 48 48 48 48 48 48 48 48 
48 48 48 48 48 48 48 48 48 48 48 48 48 48 48 
48 48 48 48 48 48 48 48 48 48 48 48 48 48 48 
48 48 48 48 48 48 48 48 48 48 48 48 48 48 48 
48 48 48 48 48 48 48 48 48 48 48 48 48 48 48 
48 48 48 48 48 48 48 48 48 48 48 48 48 48 48 
48 48 48 48 48 48 48 48 48 48 48 48 48 48 48 
48 48 48 48 48 48 48 48 48 48 48 48 48 48 48 
48 48 48 48 48 48 48 48 48 48 48 48 48 48 48 
48 48 48 48 48 48 1012 1020 1023 48 48 48 48 48 48 
48 48 48 48 48 48 48 48 48 48 48 48 48 48 48 
48 48 48 1030 1045 1046 1047 1032 48 48 48 48 48 48 48 
48 48 48 1030 1046 1047 1032 48 48 48 48 48 48 48 48 
48 48 48 48 48 48 48 48 48 48 48 48 48 48 48 
48 48 48 48 48 48 48 48 48 48 48 48 48 48 48 
48 48 48 48 48 48 48 48 48 48 48 48 48 48 48 
48 48 48 48 48 48 48 48 48 48 48 48 48 48 48 
48 48 48 48 48 48 48 48 48 48 48 48 48 48 48 
48 48 48 48 48 48 48 48 48 48 48 48 48 48 48 
48 48 48 48 48 48 48 48 48 48 48 48 48 48 48 
48 48 48 48 48 48 48 48 48 48 48 48 48 48 48 
48 48 48 48 48 48 48 48 48 48 48 48 48 48 48 
48 48 48 48 48 48 48 48 48 48 48 48 48 48 48 
48 48 48 48 48 48 48 48 48 48 48 48 48 48 48 
0
0
0
