45
5
00 00 11 11 11 00 00 00 00 00 00 00 00 00 05 05 00 00 00 00 00 00 00 00 00 00 00 00 00 00 00 00 00 00 00 00 00 00 00 00 00 00 00 00 00 
00 00 11 00 11 00 00 11 11 11 11 00 00 00 05 00 00 00 00 00 00 05 00 00 00 00 00 00 00 00 00 00 00 00 00 00 00 00 00 00 00 00 00 00 00 
00 00 00 11 00 11 11 11 00 11 11 00 00 05 05 00 00 00 05 00 00 05 00 00 01 00 00 00 01 01 01 00 00 00 00 00 00 00 00 00 00 00 00 00 00 
00 00 00 11 11 11 11 11 11 11 11 00 00 00 00 05 05 05 00 05 05 05 00 00 01 00 00 01 01 00 00 01 00 00 00 00 00 00 00 00 00 00 00 00 00 
00 00 00 00 00 00 00 00 00 00 00 00 00 00 00 00 00 00 00 00 00 00 00 00 00 01 01 00 00 00 00 00 00 01 01 00 00 00 00 00 00 00 00 00 00 
