25
25
00 00 00 00 00 00 00 00 00 00 00 00 00 00 00 00 00 00 00 00 00 00 00 00 00 
00 01 01 01 01 01 01 01 01 01 01 01 01 01 01 01 01 01 01 01 01 01 01 01 00 
00 01 12 13 13 13 13 13 13 13 14 01 01 01 01 01 01 01 01 01 01 01 01 01 00 
00 01 15 16 16 16 16 16 16 16 17 01 01 01 01 01 01 01 01 01 01 01 01 01 00 
00 01 18 19 19 19 19 19 19 19 20 01 01 01 01 01 01 01 01 01 01 01 01 01 00 
00 01 21 21 21 01 01 01 01 01 01 01 01 01 01 01 01 01 01 01 01 01 01 01 00 
00 01 21 21 21 01 01 01 01 01 01 01 01 01 01 01 01 01 01 01 01 01 01 01 00 
00 01 21 21 21 01 01 01 01 01 01 01 01 01 01 01 01 01 01 01 01 01 01 01 00 
00 01 01 01 22 22 22 01 01 01 01 01 01 01 01 01 01 01 01 01 01 01 01 01 00 
00 01 01 01 22 22 22 01 01 01 01 01 01 01 01 01 01 01 01 01 01 01 01 01 00 
00 01 01 01 22 22 22 01 01 01 01 01 01 01 01 01 01 01 01 01 01 01 01 01 00 
00 01 01 01 01 01 23 23 23 01 01 01 01 01 01 01 01 01 01 01 01 01 01 01 00 
00 01 01 01 01 01 23 23 23 01 01 01 01 01 01 01 01 01 01 01 01 01 01 01 00 
00 01 01 01 01 01 23 23 23 01 01 01 01 01 01 01 01 01 01 01 01 01 01 01 00 
00 01 01 01 01 01 01 01 01 01 01 01 01 01 01 01 01 01 01 01 01 01 01 01 00 
00 01 01 01 01 01 01 01 01 01 01 01 01 01 01 01 01 01 01 01 01 01 01 01 00 
00 01 01 01 01 01 01 01 01 01 01 01 01 01 01 01 01 01 01 01 01 01 01 01 00 
00 01 01 01 01 01 01 01 01 01 01 01 01 01 01 01 01 01 01 01 01 01 01 01 00 
00 01 01 01 01 01 01 01 01 01 01 01 01 01 01 01 01 01 01 01 01 01 01 01 00 
00 01 01 01 01 01 01 01 01 01 01 01 01 01 01 01 01 01 01 01 01 01 01 01 00 
00 01 01 01 01 01 01 01 01 01 01 01 01 01 01 01 01 01 01 01 01 01 01 01 00 
00 01 01 01 01 01 01 01 01 01 01 01 01 01 01 01 01 01 01 01 01 01 01 01 00 
00 01 01 01 01 01 01 01 01 01 01 01 01 01 01 01 01 01 01 01 01 01 01 01 00 
00 01 01 01 01 01 01 01 01 01 01 01 01 01 01 01 01 01 01 01 01 01 01 01 00 
00 00 00 00 00 00 00 00 00 00 00 00 00 00 00 00 00 00 00 00 00 00 00 00 00 
08 10 10 10 10 10 10 10 10 10 10 10 10 10 10 10 10 10 10 10 10 10 10 10 06 
08 00 00 00 00 00 00 00 00 00 00 00 00 00 00 00 00 00 00 00 00 00 00 00 06 
08 00 00 00 00 00 00 00 00 00 00 00 00 00 03 04 04 04 04 05 00 00 00 00 06 
08 00 00 00 00 00 00 00 00 00 00 00 00 00 06 07 07 07 07 08 00 00 00 00 06 
08 00 00 00 00 00 00 00 00 00 00 00 00 00 06 07 07 07 07 08 00 00 00 00 06 
08 00 00 00 00 00 00 00 00 00 00 00 00 00 06 07 07 07 07 08 00 00 00 00 06 
08 00 00 00 00 00 00 00 00 00 00 00 00 00 06 07 07 07 07 08 00 00 00 00 06 
08 00 00 00 00 00 00 00 00 00 00 00 00 00 06 07 07 07 07 08 00 00 00 00 06 
08 00 00 00 00 00 00 00 00 00 00 00 00 00 06 07 07 07 07 08 00 00 00 00 06 
08 00 00 00 00 00 00 00 00 00 00 00 00 00 06 07 07 07 07 08 00 00 00 00 06 
08 00 00 00 00 00 00 00 00 00 00 00 00 00 06 07 07 07 07 08 00 00 00 00 06 
08 00 00 00 00 00 00 00 00 00 00 00 00 00 06 07 07 07 07 08 00 00 00 00 06 
08 00 00 00 00 00 00 00 00 00 00 00 00 00 06 07 07 07 07 08 00 00 00 00 06 
08 00 00 00 00 00 00 00 00 00 00 00 00 00 06 07 07 07 07 08 00 00 00 00 06 
08 00 00 00 00 00 00 00 00 00 00 00 00 00 09 10 10 10 10 11 00 00 00 00 06 
08 00 00 00 00 00 00 00 00 00 00 00 00 00 00 00 00 00 00 00 00 00 00 00 06 
08 00 00 00 00 00 00 00 00 00 00 03 04 04 04 04 04 04 04 04 04 04 05 00 06 
08 00 00 00 00 00 00 00 00 00 00 06 07 07 07 07 07 07 07 07 07 07 08 00 06 
08 00 00 00 00 00 00 00 00 00 00 06 07 07 07 07 07 07 07 07 07 07 08 00 06 
08 00 00 00 00 00 00 00 00 00 00 06 07 07 07 07 07 07 07 07 07 07 08 00 06 
08 00 00 00 00 00 00 00 00 00 00 06 07 07 07 07 07 07 07 07 07 07 08 00 06 
08 00 00 00 00 00 00 00 00 00 00 06 07 07 07 07 07 07 07 07 07 07 08 00 06 
08 00 00 00 00 00 00 00 00 00 00 06 07 07 07 07 07 07 07 07 07 07 08 00 06 
08 00 00 00 00 00 00 00 00 00 00 06 07 07 07 07 07 07 07 07 07 07 08 00 06 
07 04 04 04 04 04 04 04 04 04 04 07 07 07 07 07 07 07 07 07 07 07 07 04 07 
2
1
13
8
3
2
1
11
11
2
2
12
0
1
1
-1
3
0
11
5
-1
3
3
14
15
3
3
4
23
23
-1
3
4
20
2
-1
3
4
3
9
-1
3
4
6
3
-1
3
0
3
6
-1
3
0
6
8
-1
3
0
6
13
-1
3
0
10
2
-1
3
3
14
1
6
3
