2.8
Museum
15
15
01 01 01 01 01 01 01 01 01 01 01 01 00 00 00 
01 01 01 01 01 01 01 01 01 01 01 01 00 00 00 
01 01 01 01 01 01 01 01 01 01 01 01 00 00 00 
01 01 01 01 01 01 01 01 01 01 01 01 00 00 00 
01 01 01 01 01 01 01 01 01 01 01 01 00 00 00 
01 01 01 01 01 01 01 01 01 01 01 01 00 00 00 
01 01 01 01 01 01 01 01 01 01 01 01 00 00 00 
01 01 01 01 01 01 01 01 01 01 01 01 00 00 00 
01 01 01 01 01 01 01 01 01 01 01 01 00 00 00 
01 01 01 01 01 01 01 01 01 01 01 01 00 00 00 
01 01 01 01 01 01 01 01 01 01 01 01 00 00 00 
00 00 00 00 00 00 00 00 00 00 00 00 00 00 00 
00 00 00 00 00 00 00 00 00 00 00 00 00 00 00 
00 00 00 00 00 00 00 00 00 00 00 00 00 00 00 
00 00 00 00 00 00 00 00 00 00 00 00 00 00 00 
00 00 00 00 00 00 00 00 00 00 00 00 00 00 00 
00 00 00 00 1028 1029 1015 1015 1015 00 00 00 00 00 00 
00 00 00 00 00 00 00 00 00 00 00 00 00 00 00 
00 00 00 1033 1048 1049 1050 1035 00 00 00 00 00 00 00 
00 00 00 1033 1049 1050 1035 00 00 00 00 00 00 00 00 
00 00 00 00 00 00 00 00 00 00 00 00 00 00 00 
00 00 00 00 00 00 00 00 00 00 00 00 00 00 00 
00 00 00 00 00 00 00 00 00 00 00 00 00 00 00 
00 00 00 00 00 00 00 00 00 00 00 00 00 00 00 
00 00 00 00 00 00 00 00 00 00 00 00 00 00 00 
00 00 00 00 00 00 00 00 00 00 00 00 00 00 00 
00 00 00 00 00 00 00 00 00 00 00 00 00 00 00 
00 00 00 00 00 00 00 00 00 00 00 00 00 00 00 
00 00 00 00 00 00 00 00 00 00 00 00 00 00 00 
00 00 00 00 00 00 00 00 00 00 00 00 00 00 00 
00 00 00 00 00 00 1012 1020 1023 00 00 00 00 00 00 
00 00 00 00 00 00 00 00 00 00 00 00 00 00 00 
00 00 00 1030 1045 1046 1047 1032 00 00 00 00 00 00 00 
00 00 00 1030 1046 1047 1032 00 00 00 00 00 00 00 00 
00 00 00 00 00 00 00 00 00 00 00 00 00 00 00 
00 00 00 00 00 00 00 00 00 00 00 00 00 00 00 
00 00 00 00 00 00 00 00 00 00 00 00 00 00 00 
00 00 00 00 00 00 00 00 00 00 00 00 00 00 00 
00 00 00 00 00 00 00 00 00 00 00 00 00 00 00 
00 00 00 00 00 00 00 00 00 00 00 00 00 00 00 
00 00 00 00 00 00 00 00 00 00 00 00 00 00 00 
00 00 00 00 00 00 00 00 00 00 00 00 00 00 00 
00 00 00 00 00 00 00 00 00 00 00 00 00 00 00 
00 00 00 00 00 00 00 00 00 00 00 00 00 00 00 
00 00 00 00 00 00 00 00 00 00 00 00 00 00 00 
0
0
0
