3.3
Museum
15
15
00 00 00 00 00 00 00 00 00 00 00 00 00 00 00 
00 00 00 00 00 00 00 00 00 00 00 00 00 00 00 
00 00 00 00 00 00 00 00 00 00 00 00 00 00 00 
00 00 01 01 01 01 01 01 01 01 01 00 00 00 00 
00 00 01 01 01 01 01 01 01 01 01 00 00 00 00 
00 00 01 01 01 01 01 01 01 01 01 00 00 00 00 
00 00 01 01 01 01 01 01 01 01 01 00 00 00 00 
00 00 01 01 01 01 01 01 01 01 01 00 00 00 00 
00 00 01 01 01 01 01 01 01 01 01 00 00 00 00 
00 00 01 01 01 01 01 01 01 01 01 00 00 00 00 
00 00 01 01 01 01 01 01 01 01 01 00 00 00 00 
00 00 01 01 01 01 01 01 01 01 01 00 00 00 00 
00 00 00 00 00 00 00 00 00 00 00 00 00 00 00 
00 00 00 00 00 00 00 00 00 00 00 00 00 00 00 
00 00 00 00 00 00 00 00 00 00 00 00 00 00 00 
00 00 00 00 00 00 00 00 00 00 00 00 00 00 00 
00 14 05 05 05 05 05 05 05 05 05 14 00 00 00 
00 14 04 04 04 04 04 04 04 04 04 14 00 00 00 
00 14 00 00 00 00 00 00 00 1044 1039 14 00 00 00 
00 14 00 00 00 1055 00 00 00 1044 00 14 00 00 00 
00 14 00 00 00 00 00 00 00 1043 00 14 00 00 00 
00 14 00 1025 1026 00 00 00 00 1040 00 14 00 00 00 
00 14 00 00 00 00 00 00 00 00 00 14 00 00 00 
00 14 00 00 00 00 00 00 00 00 00 14 00 00 00 
00 14 1033 1042 1049 1050 1048 1035 00 00 00 14 00 00 00 
00 14 00 00 00 00 00 00 00 00 00 14 00 00 00 
00 14 00 00 00 00 00 00 00 00 00 14 00 00 00 
00 05 05 05 05 05 05 05 05 05 05 05 00 00 00 
00 04 04 04 04 04 04 04 04 04 04 04 00 00 00 
00 00 00 00 00 00 00 00 00 00 00 00 00 00 00 
00 26 25 25 25 25 25 25 25 25 25 24 00 00 00 
00 29 11 11 11 11 11 11 11 11 11 27 00 00 00 
00 00 00 00 00 00 00 00 00 1038 1036 00 00 00 00 
00 00 00 00 00 1052 00 00 00 00 00 00 00 00 00 
00 00 00 00 00 00 00 00 00 00 00 00 00 00 00 
00 00 00 00 00 00 00 00 00 00 00 00 00 00 00 
00 00 00 00 00 00 00 00 00 00 00 00 00 00 00 
00 00 00 00 00 00 00 00 00 00 00 00 00 00 00 
00 00 1030 1031 1046 1047 1045 1032 00 00 00 00 00 00 00 
00 00 00 00 00 00 00 00 00 00 00 00 00 00 00 
00 00 00 00 00 00 00 00 00 00 00 00 00 00 00 
00 19 25 25 25 25 25 25 25 25 25 18 00 00 00 
00 10 11 11 11 11 11 11 11 11 11 09 00 00 00 
00 00 00 00 00 00 00 00 00 00 00 00 00 00 00 
00 00 00 00 00 00 00 00 00 00 00 00 00 00 00 
0
3
9
2
3
-1
3
null
null
-1
-1
2
7
7
-1
3
null
null
-1
-1
2
8
6
-1
3
null
null
-1
-1
0
