2.8
Prison1
20
20
00 00 00 00 00 00 00 00 00 00 00 00 00 00 00 00 00 00 00 00 
00 00 00 00 00 00 00 00 00 00 00 00 00 00 00 00 00 00 00 00 
00 00 00 00 00 00 00 00 00 00 00 00 00 00 00 00 00 00 00 00 
00 00 00 00 00 04 00 00 00 00 00 00 00 00 00 00 00 00 00 00 
00 00 00 01 01 01 01 01 01 00 00 00 00 00 00 00 00 00 00 00 
00 00 00 01 01 01 01 01 01 00 00 00 00 00 00 00 00 00 00 00 
00 00 00 01 01 01 01 01 01 00 00 00 00 00 00 00 00 00 00 00 
00 00 01 01 01 01 01 01 01 00 00 00 00 00 00 00 00 00 00 00 
00 00 00 01 01 01 01 01 01 01 01 01 01 01 00 00 00 00 00 00 
00 00 00 01 01 01 01 01 01 01 01 01 01 01 00 00 00 00 00 00 
00 00 00 01 01 01 01 01 01 01 01 01 01 01 00 00 00 00 00 00 
00 00 00 01 01 01 01 01 01 01 01 01 01 01 00 00 00 00 00 00 
00 00 00 01 01 01 01 01 01 01 01 01 01 01 00 00 00 00 00 00 
00 00 00 00 00 00 00 00 00 00 00 00 00 00 00 00 00 00 00 00 
00 00 00 00 00 00 00 00 00 00 00 00 00 00 00 00 00 00 00 00 
00 00 00 00 00 00 00 00 00 00 00 00 00 00 00 00 00 00 00 00 
00 00 00 00 00 00 00 00 00 00 00 00 00 00 00 00 00 00 00 00 
00 00 00 00 00 00 00 00 00 00 00 00 00 00 00 00 00 00 00 00 
00 00 00 00 00 00 00 00 00 00 00 00 00 00 00 00 00 00 00 00 
00 00 00 00 00 00 00 00 00 00 00 00 00 00 00 00 00 00 00 00 
00 00 00 00 00 00 00 00 00 00 00 00 00 00 00 00 00 00 00 00 
00 00 18 31 31 31 31 31 31 26 00 00 00 00 00 00 00 00 00 00 
00 00 05 05 05 05 05 05 05 14 00 00 00 00 00 00 00 00 00 00 
00 00 04 04 04 1020 04 04 04 14 00 00 00 00 00 00 00 00 00 00 
00 00 17 00 00 00 00 00 00 14 00 00 00 00 00 00 00 00 00 00 
00 00 17 00 00 00 00 00 00 28 31 31 31 31 30 00 00 00 00 00 
00 00 17 00 00 00 00 00 00 05 05 05 05 05 05 00 00 00 00 00 
00 00 00 00 00 00 00 00 00 04 04 04 04 04 04 00 00 00 00 00 
00 00 17 00 00 00 00 00 00 00 1000 1001 00 00 17 00 00 00 00 00 
00 00 17 00 00 00 00 00 00 00 1003 1004 00 00 17 00 00 00 00 00 
00 00 17 00 00 00 00 00 00 00 00 00 00 1017 17 00 00 00 00 00 
00 00 17 00 00 00 1021 1022 1017 00 00 00 00 1021 17 00 00 00 00 00 
00 00 17 00 00 00 00 00 00 00 00 00 00 1022 17 00 00 00 00 00 
00 00 17 17 17 17 17 17 17 17 17 17 17 17 17 00 00 00 00 00 
00 00 00 00 00 00 00 00 00 00 00 00 00 00 00 00 00 00 00 00 
00 00 00 00 00 00 00 00 00 00 00 00 00 00 00 00 00 00 00 00 
00 00 00 00 00 00 00 00 00 00 00 00 00 00 00 00 00 00 00 00 
00 00 00 00 00 00 00 00 00 00 00 00 00 00 00 00 00 00 00 00 
00 00 00 00 00 00 00 00 00 00 00 00 00 00 00 00 00 00 00 00 
00 00 00 00 00 00 00 00 00 00 00 00 00 00 00 00 00 00 00 00 
00 00 00 00 00 00 00 00 00 00 00 00 00 00 00 00 00 00 00 00 
00 00 00 00 00 00 00 00 00 00 00 00 00 00 00 00 00 00 00 00 
00 00 00 00 00 00 00 00 00 00 00 00 00 00 00 00 00 00 00 00 
00 00 15 00 00 1023 00 00 00 00 00 00 00 00 00 00 00 00 00 00 
00 00 14 00 00 00 00 00 00 00 00 00 00 00 00 00 00 00 00 00 
00 00 14 00 00 00 00 00 00 00 00 00 00 00 00 00 00 00 00 00 
00 00 16 00 00 00 00 00 00 00 00 00 1008 00 00 00 00 00 00 00 
00 00 15 00 00 00 00 00 00 00 00 00 1011 00 15 00 00 00 00 00 
00 00 14 00 00 00 00 00 00 00 00 00 00 00 14 00 00 00 00 00 
00 00 14 00 00 00 00 00 00 00 00 00 00 1014 14 00 00 00 00 00 
00 00 14 00 00 00 1018 1019 1014 00 00 00 00 1018 14 00 00 00 00 00 
00 00 14 00 00 00 00 00 00 00 00 00 00 1019 14 00 00 00 00 00 
00 00 34 08 08 08 08 08 08 08 08 08 08 08 33 00 00 00 00 00 
00 00 10 11 11 11 11 11 11 11 11 11 11 11 09 00 00 00 00 00 
00 00 00 00 00 00 00 00 00 00 00 00 00 00 00 00 00 00 00 00 
00 00 00 00 00 00 00 00 00 00 00 00 00 00 00 00 00 00 00 00 
00 00 00 00 00 00 00 00 00 00 00 00 00 00 00 00 00 00 00 00 
00 00 00 00 00 00 00 00 00 00 00 00 00 00 00 00 00 00 00 00 
00 00 00 00 00 00 00 00 00 00 00 00 00 00 00 00 00 00 00 00 
00 00 00 00 00 00 00 00 00 00 00 00 00 00 00 00 00 00 00 00 
4
1
5
5
546
2
23
5
8
7
9563
2
23
11
4
4
1
2
-1
11
3
6
1
2
-1
9
4
7
5
-1
3
guy
null
-1
-1
0
3
4
3
3
null
null
-1
-1
9
8
8
-1
3
null
null
-1
-1
2
7
8
-1
3
null
null
-1
-1
6
8
4
7
3
null
W
3
-1
6
13
9
3
3
null
N
6
-1
7
3
10
2
3
null
E
1
-1
3
2
7
2
3
null
E
-1
-1
10
8
6
6
3
toggle
W
33
2
4
4
8
0
12
2
3
7
1
-1
-1
6
6
2
3
-1
4
5
3
1
-1
