2.8
Museum
15
15
00 00 00 00 00 00 00 00 00 00 00 00 00 00 00 
01 01 01 01 01 01 01 01 01 01 01 01 01 01 01 
01 01 01 01 01 01 01 01 01 01 01 01 01 01 01 
01 01 01 01 01 01 01 01 01 01 01 01 01 01 01 
01 01 01 01 01 01 01 01 01 01 01 01 01 01 01 
01 01 01 01 01 01 01 01 01 01 01 01 01 01 01 
01 01 01 01 01 01 01 01 01 01 01 01 01 01 01 
01 01 01 01 01 01 01 01 01 01 01 01 01 01 01 
01 01 01 01 01 01 01 01 01 01 01 01 01 01 01 
01 01 01 01 01 01 01 01 01 01 01 01 01 01 01 
01 01 01 01 01 01 01 01 01 01 01 01 01 01 01 
01 01 01 01 01 01 01 01 01 01 01 01 01 01 01 
01 01 01 01 01 01 01 01 01 01 01 01 01 01 01 
01 01 01 01 01 01 01 01 01 01 01 01 01 01 01 
01 01 01 01 01 01 01 01 01 01 01 01 01 01 01 
00 00 00 00 00 00 00 00 00 00 00 00 00 00 00 
05 05 05 05 05 05 05 05 05 05 05 05 05 05 05 
04 04 04 04 04 04 04 04 04 04 04 04 04 04 04 
14 00 00 00 00 00 00 00 00 00 00 00 00 00 14 
14 00 00 00 00 00 00 00 00 00 00 00 00 00 14 
14 00 00 00 00 00 00 00 00 00 00 00 00 00 14 
14 00 00 00 00 00 00 00 00 00 00 00 00 00 14 
14 00 00 00 00 00 00 00 00 00 00 00 00 00 14 
14 00 00 00 00 00 00 00 00 00 00 00 00 00 14 
14 00 00 00 00 00 00 00 00 00 00 00 00 00 14 
14 00 00 00 00 00 00 00 00 00 00 00 00 00 14 
14 00 00 00 00 00 00 00 00 00 00 00 00 00 14 
14 00 00 00 00 00 00 00 00 00 00 00 00 00 14 
14 00 00 00 00 00 00 00 00 00 00 00 00 00 14 
05 05 05 05 05 05 05 05 05 05 05 05 05 05 05 
07 08 08 08 08 08 08 08 08 08 08 08 08 08 06 
22 11 11 11 11 11 11 11 11 11 11 11 11 11 21 
15 00 00 00 00 00 00 00 00 00 00 00 00 00 15 
00 00 00 00 00 00 00 00 00 00 00 00 00 00 00 
00 00 00 00 00 00 00 00 00 00 00 00 00 00 00 
00 00 00 00 00 00 00 00 00 00 00 00 00 00 00 
00 00 00 00 00 00 00 00 00 00 00 00 00 00 00 
00 00 00 00 00 00 00 00 00 00 00 00 00 00 00 
00 00 00 00 00 00 00 00 00 00 00 00 00 00 00 
00 00 00 00 00 00 00 00 00 00 00 00 00 00 00 
00 00 00 00 00 00 00 00 00 00 00 00 00 00 00 
00 00 00 00 00 00 00 00 00 00 00 00 00 00 00 
00 00 00 00 00 00 00 00 00 00 00 00 00 00 00 
19 08 08 08 08 08 08 08 08 08 08 08 08 08 18 
10 11 11 11 11 11 11 11 11 11 11 11 11 11 09 
0
0
0
