20
20
00 00 00 00 00 00 00 00 00 00 00 00 00 00 00 00 00 00 00 00 
00 00 00 00 00 00 00 00 00 00 00 00 00 00 00 00 00 00 00 00 
00 00 00 00 00 00 00 00 00 00 00 00 00 00 00 00 00 00 00 00 
00 00 00 00 00 00 00 00 00 00 00 00 00 00 00 00 00 00 00 00 
00 00 00 01 01 01 01 01 01 00 00 00 00 00 00 00 00 00 00 00 
00 00 00 01 01 01 01 01 01 00 00 00 00 00 00 00 00 00 00 00 
00 00 00 01 01 01 01 01 01 00 00 00 00 00 00 00 00 00 00 00 
00 00 01 01 01 01 01 01 01 00 00 00 00 00 00 00 00 00 00 00 
00 00 00 01 01 01 01 01 01 01 01 01 01 01 00 00 00 00 00 00 
00 00 00 01 01 01 01 01 01 01 01 01 01 01 00 00 00 00 00 00 
00 00 00 01 01 01 01 01 01 01 01 01 01 01 00 00 00 00 00 00 
00 00 00 01 01 01 01 01 01 01 01 01 01 01 00 00 00 00 00 00 
00 00 00 01 01 01 01 01 01 01 01 01 01 01 00 00 00 00 00 00 
00 00 00 00 00 00 00 00 00 00 00 00 00 00 00 00 00 00 00 00 
00 00 00 00 00 00 00 00 00 00 00 00 00 00 00 00 00 00 00 00 
00 00 00 00 00 00 00 00 00 00 00 00 00 00 00 00 00 00 00 00 
00 00 00 00 00 00 00 00 00 00 00 00 00 00 00 00 00 00 00 00 
00 00 00 00 00 00 00 00 00 00 00 00 00 00 00 00 00 00 00 00 
00 00 00 00 00 00 00 00 00 00 00 00 00 00 00 00 00 00 00 00 
00 00 00 00 00 00 00 00 00 00 00 00 00 00 00 00 00 00 00 00 
00 00 00 00 00 00 00 00 00 00 00 00 00 00 00 00 00 00 00 00 
00 00 00 00 00 00 00 00 00 00 00 00 00 00 00 00 00 00 00 00 
00 00 00 00 00 00 00 00 00 00 00 00 00 00 00 00 00 00 00 00 
00 00 39 25 25 25 25 25 25 39 00 00 00 00 00 00 00 00 00 00 
00 00 29 00 00 00 00 00 00 39 00 00 00 00 00 00 00 00 00 00 
00 00 26 00 00 00 00 00 00 37 00 00 00 00 00 00 00 00 00 00 
00 00 25 00 00 00 00 00 00 26 00 00 00 00 00 00 00 00 00 00 
00 00 00 00 00 00 00 00 00 25 25 25 25 25 39 00 00 00 00 00 
00 00 39 00 00 00 00 00 00 00 00 00 00 00 39 00 00 00 00 00 
00 00 39 00 00 00 00 00 00 00 00 00 00 00 39 00 00 00 00 00 
00 00 39 00 00 00 00 00 00 00 00 00 00 00 39 00 00 00 00 00 
00 00 37 00 00 00 00 00 00 00 00 00 00 00 36 00 00 00 00 00 
00 00 26 00 00 00 00 00 00 00 00 00 00 00 26 00 00 00 00 00 
00 00 25 25 25 25 25 25 25 25 25 25 25 25 25 00 00 00 00 00 
00 00 00 00 00 00 00 00 00 00 00 00 00 00 00 00 00 00 00 00 
00 00 00 00 00 00 00 00 00 00 00 00 00 00 00 00 00 00 00 00 
00 00 00 00 00 00 00 00 00 00 00 00 00 00 00 00 00 00 00 00 
00 00 00 00 00 00 00 00 00 00 00 00 00 00 00 00 00 00 00 00 
00 00 00 00 00 00 00 00 00 00 00 00 00 00 00 00 00 00 00 00 
00 00 00 00 00 00 00 00 00 00 00 00 00 00 00 00 00 00 00 00 
00 00 00 00 00 00 00 00 00 00 00 00 00 00 00 00 00 00 00 00 
00 00 34 40 40 40 40 40 40 35 00 00 00 00 00 00 00 00 00 00 
00 00 39 26 26 26 26 26 26 39 00 00 00 00 00 00 00 00 00 00 
00 00 00 00 00 00 00 00 00 00 00 00 00 00 00 00 00 00 00 00 
00 00 00 00 00 00 00 00 00 00 00 00 00 00 00 00 00 00 00 00 
00 00 00 00 00 00 00 00 00 00 40 40 40 40 35 00 00 00 00 00 
00 00 28 00 00 00 00 00 00 00 26 26 26 26 39 00 00 00 00 00 
00 00 39 00 00 00 00 00 00 00 00 00 00 00 00 00 00 00 00 00 
00 00 00 00 00 00 00 00 00 00 00 00 00 00 00 00 00 00 00 00 
00 00 00 00 00 00 00 00 00 00 00 00 00 00 00 00 00 00 00 00 
00 00 00 00 00 00 00 00 00 00 00 00 00 00 00 00 00 00 00 00 
00 00 00 40 40 40 40 40 40 40 40 40 40 40 00 00 00 00 00 00 
00 00 00 26 26 26 26 26 26 26 26 26 26 26 00 00 00 00 00 00 
00 00 00 00 00 00 00 00 00 00 00 00 00 00 00 00 00 00 00 00 
00 00 00 00 00 00 00 00 00 00 00 00 00 00 00 00 00 00 00 00 
00 00 00 00 00 00 00 00 00 00 00 00 00 00 00 00 00 00 00 00 
00 00 00 00 00 00 00 00 00 00 00 00 00 00 00 00 00 00 00 00 
00 00 00 00 00 00 00 00 00 00 00 00 00 00 00 00 00 00 00 00 
00 00 00 00 00 00 00 00 00 00 00 00 00 00 00 00 00 00 00 00 
00 00 00 00 00 00 00 00 00 00 00 00 00 00 00 00 00 00 00 00 
2
1
5
5
546
2
23
5
8
7
9563
2
23
6
4
7
5
-1
3
guy
null
-1
-1
0
3
4
3
3
null
null
-1
-1
9
8
8
-1
3
null
null
-1
-1
2
7
8
-1
3
null
null
-1
-1
6
8
4
7
3
null
W
3
-1
6
13
9
3
3
null
N
6
3
2
6
8
1
-1
4
8
0
12
